12
init.map
wwwwwwwwwwwwwwwwwwwwwwwwwwwwwwwwwwwwwwwwwwwwwwwwwwwww
w                                                   w
w                                                   w
w                                                   w
w    b      b   bbbbbb   b    b                     w
w     bb  bb    b    b   b    b                     w
w       bb      b    b   b    b                     w
w       bb      b    b   b    b                     w
w       bb      bbbbbb   bbbbbb                     w
w                                                   w
w                      p                            w
w            b       b   b  bb    b                 w
w            b       b   b  b b   b                 w
w            b   b   b   b  b  b  b                 w
w             b b b b    b  b   b b                 w
w              b   b     b  b    bb                 w
w                                         ll  ll    w
w                                         ll  ll    w
w                                       l        l  w
w                                        llllllll   w
w                                         llllll    w
wwwwwwwwwwwwwwwwwwwwwwwwwwwwwwwwwwwwwwwwwwwwwwwwwwwww