12
level12.map
wwwwwwwwwwww
w     l    w
w    b     w
w          w
w bb       w
w wwel     w 
w          w
w    p     w
w  ww      w
w    b     w
wwwwwwwwwwww