6
level8.map
wwwwwwwwww
wp  l     
w        w
w   w    w
w   w    w
w  bw    w
w        w
wl       w
w     e  w
w   wwww w