3
level4.map
w   wwww
w p    w
w      w
w      w
w      w
w      w
w wwww w
w wwww w
w wwww w
w e   bw
w      w
w www  w