4
level5.map
wwwwwwwwwwww
w          w
w p   l b  w
w          w
w          w
w l        w
w          w
w   lb     w
w   e      w
w  wwwwwwwww
