8
level11.map
wwwwwwwwwwww
wp     b    
w          w
w          w
w      l  bw
w  e       w 
w          w
wb         w
w          w
w          w
w   wwwwwwww