5
level7.map
wwwwwwwwww
wp       w
w        w
w        w
w lbwww  w
w    ew  w
w   www  w
w        w
w b      w
w wwwwwwww