5
level9.map
wwwwwwwwwww
w         w
w w   b w w
w w     w w
wb l p    w
w       e w
w w     w w
w wb    w w
w         w
wwwwwwwwwww